20x20
####################
#P    #    T       #
# ### # ###### ### #
# #        #     # #
# # ###### # ##### #
# # #    T # #   A #
#   # #### # # ### #
# ### #    # #   # #
#     # #### ### # #
####### #  A   # # #
#T      ###### # # #
# #####      # # # #
# #   ######## # # #
# # A #   T    #   #
# ##### ###### #####
#     # #    #     #
### # # # ## ##### #
#   # # T  # #S    #
# ### ###### # ### #
#            #     #
####################